##########
#*#......#
#.#.#?#..#
#.#.#?#!.#
#...#...##
#.#.#....#
#####!##.#
#..@#!##^#
#..%.....#
##########